! TanksGame
! # = Tile Legend 
! 1 = Wall
! 2 = Container
11111111111111111111
1                  1
1      2222        1
1      2222        1
1      2222        1
1      2222        1
1             222221
1             222221
1              22221
1222222222      2221
1                221
1                 21
1                  1
1         2222222221
1                  1
1222222222222      1
122222222222222    1
1                  1
1                  1
11111111111111111111
